arg|argparse.Options{}|go
enable|enableAuth|buffer
authE|authEndpoint|buffer
ena|enableAuth|go
auth|authEndpoint|go
Exi|Exit|go
A|Args|go
P|Parse|go
valida|validateAuthEndpoint|go
validate|Validate|go
contain|Contains|go
New|New|go
strings.|HasPrefix|go
|split!|go
parser|parser.Flag|go
enable|enableAuth|go
argparse|argparse.Options{}|go
O|Options{}|go
|Options{}|go
Flag|Flag|go
R|Required|go
Parser|NewParser|go
argp|argparse|go
aka|akamensky/"|go
gith|github.com/"|go
a8|a89984|around
|UserAgent|go
|Error|go
S|Second)|go
kill|killTimeout|around
get|getEnvironmentVars|go
|New|go
errors|errors|go